48 10
################################################
#   #      #          #  #     #    #      #   #
#   #   ####  #####  ##  ### ##### ##  ####### #
# ###   #  #  # # #  ##   ## #  ##  #  #  @  # #
# # ### #     #   #  ##   ## #   #  #  #     # #
# # #   #  #  # # #  ##   ## #   #  #  #     # #
#   ### ####  #####  ##   ## #   #  #  ### ### #
#   # #                   #  ## ##     #     # #
# #     ####         #              #     #    #
#E##############################################